"filename", "language", "vue", "TypeScript", "JavaScript", "JSON", "CSS", "comment", "blank", "total"
"d:\desktop\PinesWebPro\pines3.0\package-lock.json", "JSON", 0, 0, 0, 2, 0, 1136, 0, 1138
"d:\desktop\PinesWebPro\pines3.0\package.json", "JSON", 0, 0, 0, 3, 0, 0, 0, 3
"d:\desktop\PinesWebPro\pines3.0\src\App.vue", "vue", -1, 0, 0, 0, 0, 0, 0, -1
"d:\desktop\PinesWebPro\pines3.0\src\api\dist\index.js", "JavaScript", 0, 0, 0, 0, 0, 4, 0, 4
"d:\desktop\PinesWebPro\pines3.0\src\api\index.ts", "TypeScript", 0, 0, 0, 0, 0, 4, 1, 5
"d:\desktop\PinesWebPro\pines3.0\src\assets\css\color-dark.css", "CSS", 0, 0, 0, 0, -28, 0, 0, -28
"d:\desktop\PinesWebPro\pines3.0\src\assets\css\color-light.css", "CSS", 0, 0, 0, 0, 15, 0, 2, 17
"d:\desktop\PinesWebPro\pines3.0\src\assets\data\pines\dist\test_1.js", "JavaScript", 0, 0, 24, 0, 0, 0, 1, 25
"d:\desktop\PinesWebPro\pines3.0\src\assets\data\pines\test_1.ts", "TypeScript", 0, 21, 0, 0, 0, 0, 0, 21
"d:\desktop\PinesWebPro\pines3.0\src\dist\main.js", "JavaScript", 0, 0, 42, 0, 0, 2, 1, 45
"d:\desktop\PinesWebPro\pines3.0\src\server\dist\index.dev.js", "JavaScript", 0, 0, 29, 0, 0, 19, 12, 60
"d:\desktop\PinesWebPro\pines3.0\src\server\index.js", "JavaScript", 0, 0, -52, 0, 0, 29, -5, -28
"d:\desktop\PinesWebPro\pines3.0\src\utils\TableAtt.ts", "TypeScript", 0, 54, 0, 0, 0, 0, 0, 54
"d:\desktop\PinesWebPro\pines3.0\src\utils\dist\TableAtt.js", "JavaScript", 0, 0, 57, 0, 0, 0, 1, 58
"d:\desktop\PinesWebPro\pines3.0\src\views\manage.vue", "vue", 167, 0, 0, 0, 0, 5, 8, 180
"Total", "-", 166, 75, 100, 5, -13, 1199, 21, 1553